                
   *****        
   *   *        
   *   *        
   *   ******   
   *  xo    *   
   *       p*   
   *        *   
   *  xo    *   
   *   ******   
   *   ******   
   *   ******   
   **********   
                
                
                
