                
                
                
        *****   
     ****x  *   
     * +oxo *   
     * o xx**   
     ***oo *    
       * ox*    
       *   *    
       *   *    
       *****    
                
                
                
                
