                
                
                
  ************  
  *    xx    *  
  * **o**o** *  
  * *  **  * *  
  * * **** * *  
  * * *xx* * *  
  * * *oo* * *  
  * * *  * * *  
  *    p     *  
  ************  
                
                
                
