                
                
                
    ****        
   **  **       
   * o  ****    
   *   opox*    
   *  *o*o *    
   *   o  **    
   * o***x**    
   *    *xx*    
   **** oxx*    
      ** xx*    
       *****    
                
                
