                
                
                
   *** *****    
   * ***   **   
  ** xx  o  *   
  *  *xx ooo**  
  * o* x**   *  
  *  **x *   *  
  * o*xx * ***  
  *   o  o *    
  **** p****    
     ****       
                
                
                
