                
                
                
    *******     
   *       **   
   ***o*    *   
   *     *o *   
   * x o *  *   
   **x****o **  
    *x       *  
   **x  o *  *  
   * x *o*****  
   * x   p*     
   ********     
                
                
