                
                
                
     ******     
     *    ***** 
     * o      * 
     * o      * 
     *oo***** * 
     *xxxxxxxx* 
     *oo*** *** 
   *** o      * 
   *   o      * 
   *p  ***    * 
   ***** ****** 
                
                
