                
                
         *****  
        **   *  
  *******  o *  
  *  o      **  
  *  **oxx **   
  ** * oxx**    
   *    xx**    
   * * *** *    
   * o     *    
   **  **o *    
    *****  *    
        *p**    
        ***     
                
